LS20 ARC-AGI-3 Initial Frame (64x64)
Legend: .=floor #=wall ' '=void *=target B=fuel @=selector 0-9=values
Rows 0-63, Cols 0-63

R00     ############################################################
R01     ############################################################
R02     ############################################################
R03     ############################################################
R04     ############################################################
R05     ############################################################
R06     ############################################################
R07     ############################################################
R08     ############################.........#######################
R09     ############################.       .#######################
R10     ############################.       .#######################
R11     ############################.  ***  .#######################
R12     ############################.    *  .#######################
R13     ############################.  * *  .#######################
R14     ############################.       .#######################
R15     ############################.       .#######################
R16     ############################.........#######################
R17     ##############################.....#########################
R18     ##############################.....#########################
R19     ##############################.....#########################
R20     ##############################.....#########################
R21     ##############################.....#########################
R22     ##############################.....#########################
R23     ##############################.....#########################
R24     ##############################.....#########################
R25     ##########........................................##########
R26     ##########........................................##########
R27     ##########........................................##########
R28     ##########........................................##########
R29     ##########........................................##########
R30     ##########...............#####....................##########
R31     ##########.......0.......#####....................##########
R32     ##########......100......#####....................##########
R33     ##########.......1.......#####....................##########
R34     ##########...............#####....................##########
R35     ##########...............#####....................##########
R36     ##########...............#####....................##########
R37     ##########...............#####....................##########
R38     ##########...............#####....................##########
R39     ##########...............#####....................##########
R40     ###############.....##########....................##########
R41     ###############.....##########....................##########
R42     ###############.....##########....................##########
R43     ###############.....##########....................##########
R44     ###############.....##########....................##########
R45     ###############...............@@@@@...............##########
R46     ###############...............@@@@@...............##########
R47     ###############...............*****...............##########
R48     ###############...............*****...............##########
R49     ###############...............*****...............##########
R50     ############################################################
R51     ############################################################
R52 ################################################################
R53 #          #####################################################
R54 #          #####################################################
R55 #  ******  #####################################################
R56 #  ******  #####################################################
R57 #  **      #####################################################
R58 #  **      #####################################################
R59 #  **  **  #####################################################
R60 #  **  **  #                                                    
R61 #          # BBBBBBBBBBBBBBBBBBBBBBBBBBBBBBBBBBBBBBBBBB 88 88 88
R62 #          # BBBBBBBBBBBBBBBBBBBBBBBBBBBBBBBBBBBBBBBBBB 88 88 88
R63 ############                                                    